######################################################################################################
#* ..*  . .. \\# ..\* ..  . *   ....#..   * . .# .# \.* . *\ *      ..  ### \#\#.   .***.*.* #.....  #
#.   *..*  \.  **.   .\.  . .    . .#. .\   ..\. ..#   .*  .\ ..  ..#..   .  .. .#\*#. ... * * *. *.*#
#.. .   #... . #.....  .*\..\#.\... .. *... * ...*.\    #  *\ ..  .  *. #    \#  * # .\ ... .. * .\*.#
# ...  .  .# .. \\. . # ..\  *\  \...  #...   .    ..\#\...*  #*.. \.. **   .\ # \.  . #... .... * ..#
#\ \\.  #.   .    ..  * ...# ...\ ...#  #.  . ... ..  . \..     ..#\. \.   \.. . # #\..  \. . . #.#*##
#*\.  ...   . .. *. .. ... \...   ...#. .  .#. ...*.\    *. . #.  \. .#. . .*  # *  #.   *  ..#.. #..#
#  .*.. ..   .  ..  . *. . .... .... **\. ..\. .**  .\....... .. .\ ## .    . .  ..  \    .   .* \ . #
#\ \. . * .\ #######\ ..\.#\   * * .*.  * *.   .\.\ .....  #. \..*.. ...  .\ *  * ##   .. ..  ..  . .#
# .*   ..\\.\.  . ##.. .*.    . .*    #  .. **# .  .#\..\##.\* .#. * . *.. #..  # #.* *.  . \  \... .#
#..  *  ..  . \\..#..  . *..\.\ \   #.   . .  .*  .. .  . .*. \. ..#  .*.. . .  .*    \ ...#* ...\...#
#*.. .  #.\ \ .*...*\.* \\   . *    * \ .  **   .#\... * ..*.  #. #  #..\ #   \ \*.\. . ...  .*  *  .#
#.#  . ..#....#  #* #.\. ..  # *   \ ..   *#..*. ..  ..*   ..\. .\* .#*. . .   .\.  \  #.\ .. **\#*\.#
# *  .. # .\  \   #   ... ..*.\. .  ..*.... .   .#  \** *    #.   . ..#  . *#.#*\.\.*..# .\. . . .  .#
#. .. .#  ..\\..#.  #\.. .. . .  .   ..  *   #  *** . *. .\* . ... *...    *. .\  \  . # . #. \*..  ##
#**#.     #*\. # #... # ..   .... *.#.   . * .\ .  .. ..  * . .  *.  \. .## *##\..*  \.. ..    *. . .#
#.#\.. \...*   \  \.... ..  .. #.   ..  ...* # #*. \ .*..  ...*  *   . *  . . .#.  .  \**. *     # .\#
#.\*.....*..  #     # .\... ..  *.# \\.*. .*. .. .  .#  *#.*.. * #   \.. ....  . ..     .. . .    .  #
# .    *.###... \ #  .##...*..     .*#.. *\\     ....  .*.  ## \\ \ .  .*. .. #. .\.* . .. . \  .#* .#
#  \..  ..  .. .#..#\ . ...   ..... .   .   ..\. . .  \ \ #....\... #.#. .#* .#...*..  .  .. \      \#
# .. ..... . . .#. \. ...  . .# . #.  .. . \...* \    ..* \. ..    \ #    .*\ ...   . #   *...*..\.* #
# * ##. .  ....\.  .  ..  ...\  .#..\\ .. *.. .##. ...*.  \\\\ . ..\ . \ .. #\ .   \. . # . *   . #*.#
#  . ....   . .. *\  ..   \..  . # ... \...*.    #  .#..# . #.# #\    .* \ \  \.#  ..\..#  *.\.  . ..#
#.. . ..  \*... .   ..  ..#*.. .*  .  .#\\ . ##\ ..#.# .   ..\  . .*\.#    . ..* . *. . . *#*.\ .#\. #
#  **\ .   .*..  ..# . . *  .*...*#.*.. \   #. ..*\* *..*\   ***\# .. .  ..\..  ...  .  ... .*.\*.\ .#
# .  *\  . \  .   \    .#..\#..\... *.. ....#     ..\   *\.  .  .#...   . #\...#*  *..#..\  # ... ..##
#.\  .\  ## .   \ #..\ .  . *#.   \\. .. ..# *.\ ...  * .*.*.#...... .. .... .*  #..  .*.    ... ..\ #
#..#... .*..#. .    . . .  *..#.   .... *   . .*.*#. . . . ..    .    . .*\\  *... \    .   .. \ . * #
#  * ...# *  \. . **.  .. . ..# ...*  ..\. .   .... . *    # ... .\\#*..#*.*.\ . \ * * ... . .. \ .. #
##. .. . .  \#\. ..* #....*. #  .. .*.. .  .. . .\ \*    .      ....  .  .#.. .# *.#. ##.. \.** ..*  #
#.   ...  ...# .. ...\.R\\ . #.. *. ..*#..*...  #  ..\.# ..*## \.#...\.    . \.....      .# .*. \ * ##
#\.  # .\. ..  .\\..   ..*  ....## #  #. \#. *.\#. ..\ .... .  ..#...... .* ..# ... . #. #..\* .. * ##
# ...\ *. #*\#..* . .*..**\  \ * . #.. ..#.  . . *   .  .\.     .. . \  # ..  *.*. .   # .# . ... #. #
#.. .  .#.. ... .. *   ..*.# .. *..\ \ * ..     ... \    .. \ .   .**#*  .. * #. \...  ... . . .. .  #
#. . . . ....*.  ..#\   .#... .  .  \. . .. *  .... \  *. *.   . ..   ..*....  .\... ... .  #.#.  *. #
#. . *.\.#. ..#...  #.   ..# \... .  #  .# .. \\ . .  #..\# ...# # \.  .. ...  . .#.\. .*.   . .  #*.#
#   #.*.   . . ..  .    #* ...  ..     ..  * #.  .   *.. * *..... #   . * .  * .  .... .  .... \. # .#
#. ...# .  \ *   *. .. ..\.. . *#     *.    \.. #. .*   #.#. .. \. * \\ .  \.  .. * .  .\  . . . .  .#
#.\\ . .  .   *.....*  #...*.**.#  * . * ..  ....   *. ..#. *.. . . .**...\# .##.\  . ...\\*  *.\\ ###
#   * \  #.  \   . .# .*\..\*#* .  ..#..#...*. . \ .\   * ..*  ... ..* ...*. ..\\. .#. #.\  . . #*\..#
#.  #.   *. #\..   ..# *   #    ... .*   *  . . . \\#  . .  #..  *   . .*..*  .**  .*. .. .  .   ..  #
#   # #\  .. ..  \. ##.     . . .. ... . . .. .. .# ..\  .   *...#.... \#..... ..\\*.#.\..  .. .*. ..#
#. .#  . *.\  .  .     .\.# ... ..   **...   **.  * \... #  .. . .*     .\..#. \ .\* .... #  . . # .##
#. . ..*.   .# ..    \#*.  ..... . ..  ...\. ..  \*..  \ \  ##  *     ..  . .. .#...*. ..   #..  ..  #
#.   .   #  ....  ....\.# .*\. ..   \ .. \  *# .*...*.  .  . \ ..  .  \.  .....\#.\ #..\*...\*.#..#..#
#.  . . ..#  **.\. .... . .*.# ..  # .  .\.. .*.. .# \.#..*    \.\    ..  .  .    ##.  .*..   .\*\.  #
#  .#    ..  #..  *.# .# \\ #*   \.# .##. .  .*#.. .. .****  .  .*.. * ....    *** *.. *.. \#... #.  #
# # .*. ......*  ..# . .....\ #.. ..  . .*   . ....##*.\#  ... .# .  \#.\. .. * *. .* .#.   .   ..*..#
# \.. .. \** .#  \..   # .  \ .  .. .. *. .** . .\*#*.  ...\ . \ .# ... .*...   . ...**.\*. . #.\* . #
#\\....       .\* ........ \ . *# \.*  . *\# ... * #...  ...  .. *\.   #..... ..    \...*#. \. . .. .#
# *.  ... #*\.*.     \ \.   \*\\  *.    \.* .  *..#  .   .  . .  ## \  * .  ..  #. *..*. * . \. . # .#
#  * ... \#.#.\. \..*\...\.  \  #..  \  # .* .*  *. *..  \  .  *. . *.. #.\. \\.*.    ..    ..  *... #
#..**..   .*.*   *..... .# #  * #  .  ..#.\ \..    *  * .* ..  .\    .  . .. .  .. .   ...# *. \#  .*#
#.*\   .#.. . ..# \.\\.  . .\ ..*.*   . \  .. #.. .\.. * ... *..# . ... #. .\..*. . \   \  .**.. .#. #
#. .. .. ..   . ... ..\. \ . .  . .# #. . .. ..*.   *.# . ..\\    .\..\  . .   #   #  *#.  *. #. . .##
# . . \ .#.*#. .\ .  *.  ... .* .. . .## *\  ....  ..* #.      .  .  . .#..#*\ # .#.  ..  * . .  *.#.#
#. .\..\# . \ *\ ..   *  .*  .  # \  .. .    \...   *..#   * *\.. \ ..  . #.  #.  .. .\... #  # .. ..#
#\. \..*  ..# \. ...... . *.  *. .\.   .\.. # .  # . ... . \# ...#..\ *   #\  ..  ... ..   *.. .* ...#
#  . *. #  .. . . .       .*. .*# . #  \#....  . .  .  \#    ..  \ .... . *  #* .. .  *\\.. \.. * *.*#
#\  . # # *..*... *  ...\   * ... .   ...*.#    .  #.. . *. .  ** .   #  . . .  . *\* \* . .  \.  ...#
#     *...   \  ..# #*    #. *.. # #\.*  .  **# .  .. ...    ..  #* .*   .. *   ..#.*.* .#\* ##. #\..#
#. ..  #.\...    #.    .    .   \   .# .#.. ..\..#.. . * .#\#       ....    .   #.    . * ..     .. .#
#.*\ .  #.* \   . . ...  ## . .\. ... ..*  ...*\#   .*.   ## ..* *   ##. ..#* . ...  . .\... ..#. \ .#
# .. #  ...#.  ..  ...\.. . .  .     ....**    \#. #\.     \  .. ...  \ ..#... . .  \ .*     .#. . . #
#\# \ .. ..\.#.. \ .. \ *.. ..   .   .\..   ..* *..\   ..\  ..*\ . . # . ...  *  #        .. . .\ .  #
#.# \.* *  # .. . . .\...  .#.*.# .\\ *..** * ...  \.\...  \**..  #.. .  .... ...\.      # **  #\.  .#
# . .. .#...     \\.  ...\  .\.*..#.#  . . . .* \.*.\. .\ . # . ...\  . .* ...#.. #.* . \    ** #    #
#.# .\ .  #.\ .. . . .....    \*..  ...**. .. ..   .. .. .... .#\#.. . .. *# . ..*\#. \* \ .*\ #..\  #
#*# .     ..\ . #..  #..# *.. \* ...\.  ..*..## . .. . . . .. ..  ... *. . .# \\*   ..   ...  \*\#.*.#
# .. ... ##   .*    .  #*. ..  \.*.\.\..#. ...\\ .##.#  .#*...* .. . . * ...  #\\  ##  # . ..\. . .. #
#\ \      .## .      .\  ...  .. . . ..# .* . ...*..\ .#.*.#\    .#*.\#.....   .  ....  .\ \#. . \   #
#.#... .*\  # .*.\ .   .  **#. . ...*# *# . \.  . .#  *. .#.# .*....\.. . #.#...  ..  .\ #...# ..   .#
# ..\\.    #.*.  \. .  . .#* . \ . ...\ \#.. .*.    . ...# ........ \ # *\.  \#. ...  \... \.\ .   . #
#..#  . .  \ .  ..   .\.# ..#.. . #     . # .. #  ...*#.     . . \...* *   *. ....\**.#..#..\.. .  # #
#  ..#.\.\. ..  .\** .     .* \*.. .. .\\ . #.*  .*   \  .. . *.    . .  * \\  .... .\ . .  .... # . #
#.  ..   . *.# .... ..\\.  . .  ..*.    #. . . *. * . \ . . .. .....\  *.. #.  *\  *. .. \ .. * # .*.#
# ... ###.   .*   .\\.\. .   .*#..  .*  . . .. #  .*.  .  #.##. *.. \...... . # #  *.##.*\\#.  . ...##
#\   .. .#.** \.. *..   ... . # ...*. #. \   ...   .  *. ..\#.   #.. . .  .# # *\.#..  ...\\ \..  .  #
# .##\.....  *.   \ .  ..  ....\    . . . ..*.\** .    .. . .\.  * #.. . \..#.  .. . \. .. .  *#.*.*.#
#  . ..   ## ..\  .    .# .... ##...  ..\.  ....\*  \  .   #  .#...\*..  .  . .   ... .. . ..    . # #
#  #... .. *\.# ..*  \..  .\  #.* \*\..** .#\*  \*  ....# *.   . \ . .#   ... \. .. # .*. .. #    . .#
#.. *  #* .. \. .  .  .   *  . .  . .  # .# # ..\#  .. .*#... ..\# ...#\*  .. #. .  . .. *. ..* .  #.#
#.#.  .* #  #* \... .\.*.*.. ..#...... #.*  ......# .\ \  . # .  \  \ ..*.\# .## .   . .. .. # .. .. #
# \  \.*.#.   # .\ \\ .\  ..#\.   \ #. #...\.... .. *  #.....#. ..\.  ...   # .. . \ \.. ..  .. .  .*#
#. .. \  . #  #    #\  .##. # .**#.#    #    \.# . .  .....*  ...*..*   *.\  ...*\ #.. .\.# ..   . .##
#  .    *\..\#   \\  # *.  . \ #. .. .\ \ .\  #. .  #* ... *.#..\  .  .#  . .... . .*\\\..  .   *.\#*#
#    . .  ..*.... #  #. ..\.\ .*   #...  ..   #..# ..#..#. .*. \    #.\#   . \*.  ... .. ..#. .# ... #
#       ..  ### .## # .. *.. ... .# ... *  *.  ...  .#*..  ..#.  *#  .\*. .\  . #.* . . \.#   ..\.  \#
#...#.  .\  .  .*.  ..  . # \..\.\. *\. ..# #.... . .    ...* \** .  ...#....  *   ..    .. ..*\ ..  #
#....   . #..* .##....\ ..  .*. *..*.\ \. . .#  \... . ...#   \. . #\  ...  .* ..    ..**\ .  ..... *#
#. .* *#*  . \... . ......*. #  * ...\ . ......*\..  .. #   ...  ... .      \..\\  .#.....\.\...     #
#\#...*... . ..  #.\. . ..\.. . .#.   .. .  . .# \.**.  *..##. \ .... .   ........ .. .*.*. *...\*.. #
#*#\ . .....*  . *.\    * . *.# .# ...# .*  . * ..* # ..    ... .... .. *.. ..\...*#  ..  #  .   ...\#
#. *   .  .#  .  # ... \ ..  .* #  *\..\  #\. **# . ..  \  ..  .. \ \.. .#. ... #\\...###\.#..  *.  *#
#.\... *..#  # . ## . \.\.*.  .#.. . #  .#...  *\.   *. *.. .  .#. .\. .   . \ \. \L . \*  .   ..#\.*#
#.#  ..\ #.\... .\*\.# #* .**#*  #  .  . .*. ..* #  *. * . .  .. *..*. . .   . . ..#..    * .. .#   ##
#  .. ... #..\. #. . #..\ ..   \.   .*....\   . # . #.   ...  . . .*.#.*.. * *.   * .*.... *.#.  .#.##
#  ...#..  ..* .# .#. . ...   ..#.    .. . .. .  . #  # ..\*\ ... ... .\\.   \  .*\   #. \... ....#  #
# .# # * **#    ...* .  .  *.  \.. .  *# # #... .  . ..\ ...  \ .  .. *#.\..   .##... #.#\...  .#.  *#
#.... .#. ..  \ .         *..#\. . . #  #.\*. . .. ...\ . ...  \ \.\ .# ..*.. ...#. ..* . \ **    .# #
#\   .#...\  \.. *.. **.*.    .. .*#\. .    . # . .   *..*   . #  .\ .\#\  * .     .  . #. .. ... .  #
###################################################################################################### 
