##############################
#R.............#\............#
#..\######################\..#
#..\\\\\\\\\\\\\\\\\\\\\\\\..#
#............................#
#..*****.*\...*...*...*****..#
#..*\....*\....*\*..*.\\*\\..#
#..*\....****..\*\......*....#
#..*\....*\....*\*..*...*....#
#..*\....*\...*...*.....*....#
#............................#
#..\\\\\\\\\\\\\\\\\\\\\\\\..#
#................ ..... .....#
#................      #....L#
##############################
