###########################
#        # ## *.*.  *.  . #
#     # #*#*.*\.. \....***#
#    L ##*## *.. ..\*\ .*.#
#   ##.*#. # . . *.*\ ..\*#
#  #  *.#*#*...**...*.*\ \#
#  #  #  . *.  .*.*\*\.  *#
# #*... *. ...\.*** . .*\.#
##R* \.*..\  ..**..\* *** #
# \. . . *.\  .\ * *  .. .#
##**.\**.\* .. . .\.*. .  #
## #.*\* ....*.    ..***\*#
##.#\###\.\...  \... *.* .#
# ##*##\##*\*  ...* .*... #
#   # #*\.***  \ .   .. ..#
#     #* #\..*\. \ \* \  .#
#      ###\ ... \ *\* .\ .#
#       #* . .   .***\.\\\#
#        #*\*\\.   .** *. #
#         ####\ * * .\ .. #
#           #.* *##* ..*.##
#            ## *##*\#  .##
#             #*.*.\.* **.#
#              # #\#.\\####
#               #*.\  #   #
###########################