############################
#*. . * ..\ *.*#*** #      #
#.*\ .\.\ * *.*. *\.#      #
#..**\.\ ****\.\ \ ####    #
#  .* ......*. *...* *.#   #
#..  \**.*  .* . \.... #   #
#*   . * * *...* ..\# #    #
#.. *. .*\*\ .**\.*.* \#   #
#*...\\*..\ .*.***..#*#    #
#*  \.*.\\*\. *...*#\.#    #
#\.*.\...\. \....**.##.#   #
#.*. ..\\.*  .   .*\...### #
#\  .*.\ \..  ..R ..\.\...##
# . **.. ...\     .   *  #L#
#*\****\   .* *.*  \ ## ***#
############################
