#########################################################################
#..   *\   .*. .\ *. .**.. *. ... *.* ..\**   ..*..***.*. .. * ## ###   #
# \ ..*. .*.\  **.*.*.** \**\ *..*..  .*..*     *\ .   .*.#*.*.. # **#  #
#.\*...*......**. . \*.. .\..**.\ .* . \  * *   ..*.****\ \.*. \.#  ..# #
# *. ..  **\...\.\ .** \. ..*. \.\    ..  .....** *\ *.*    ..\ # #\* .##
#*\ .\. *.*. \..*.. ....**.*.\*.\ .\ *   .  *. .. ..\. . .\ .##.##. .####
# . .*\.*...  * .  *\*\ \.\.*.***\ ..\ ***  .....*. *.  .  \*\.*.#.. .. #
# .\*..****  *. *.  .\\*  ..\ *\.  ......\. *.\. . .*. *. ... **\  \*   #
#* * *\**..\.. *\... .  .*\  *.*. .** . *** \  \.*... .\  ....*\*\*.. ..#
#\  \\  .. ****.\ ..* *  .*\\..*\.\.* *.**.\...... .   *.. *  . ..*\\ ###
#.. ..\**... .\  .  ** ..*. *  *..**.*. .* *.\* \ . .  . *.*.\*** . * *\#
#..\.  .**  .    \ \ ..  ..\.  ....... ..*\*\ .\.*.* .*\ . *\* *. *\#...#
# .* . .**.*.\.  **... .* .\\  **.... .  ..*.****..* *.*. ** ..*.  . .\.#
#\..*\.\.**.\**.* .\*   ..*..\.\.  .*\* . *. .* *.. ..\. *.. .** *#.*.#*#
#* \. \. \**...\ \* **  *\.\. . .\* . .*.*\.* *... * \. *. *..\* *. .*\*#
#*  *.... ...\.** **\..  .\**  ** .\ .** . \...  \.. * .\. . **\ .* *##.#
#\   .... .*. \...\. .  * ..\*...  *. *.* *. **\...  ..\..*\*\ **.* ...*#
#..\. ..* \.* *\*  * .*...\* . .. .\*.*\.\.*. . **  .\   *..  .\  * \  .#
#** ...\.*.**. **      **.\*.. **..*......\. .* *.** . \ ..**\  * . \.\*#
#\.  .   ***.  .. \  .*..  .** .** ..\ \.....*...*.\ ..  *.**  *.  *..*.#
#*.*. \ *..\.. . *... ...*\. *   .* *\ . *.*....*...  \ ***....  ....\**#
#. .. .. ** .  \..***     ** *  * . *.\ **..*..**\. . ....*.*\.*..*\ .\*#
#\  .   . . . .** *\.\\ .*. *.. *\..***. .***..\..* *\..\.**..\.  ... \.#
#.*  . * *\.* . ..*  .  ... \* \\.\ .\*...  ..  * .\ * . .**.  . . ..  .#
#.    \**** *    .....\... \*. .*. .*** .. *\* ..\ .. ... ..*....***#\  #
#.*\.  \..* .*** . .    . *..\ . .****.. *\. .. **.\  \* * ..***\.*..  .#
#\ .. .  *..**..*\. * \*\ ..\  .*\ .*.  ..   \*. ......*\ * .*.\.*\.\ .##
#\..\*  .** ...*. .\. .  .\...  * ..*...* * . \.      ... .\\.. .*.\ .\.#
#*. .*\.***. .*.\ .  \. .  ..  .* .\.. ..** ** ****.. **. . . *  .  * . #
#.      \.*.\ .* ..\.  *  \..... *.\*.*\... *.* ..\..  . ..\\  .*.* #.**#
#.\. *. .R*.*. . .. ..\.\....*  *.**.** .\.*.  \.*...\ .  ..  \..*. . #.#
#\ ***...\...*\  \ .** .* *.....\ ..\ *.\ *. .....      .\  .   .. *\ .\#
#..*\ ..\  ...* *.  .  \*.  ..\.. *  ..\ *..\.* .. . *.*  .*\ *.*. *** .#
#*.\  *\  . **..\... .....\.\*  *....*. . *.  *..* **\.. \**.*  *\ **.* #
#* ..\.*\  **\ .   \*** **..*.**\.*\ . \.*..*.. **\...*.  .\.*..*  ...# #
#...*..*.*.**   ..  ** .\.*.\.\..\ *..   .*.\ * ..*   * .. . . \\ *.\ * #
#\* * \ \.* \ . * **.*\ *... \.   *.  *  **\ .**  .. .*...  *  ** \ *\. #
#**.* ... ..*. . *....  *.* ..  .... ***..\**..... .\*    \*  *.. .\. *.#
#\* * ..**\ .\ . .  .*\ *\. *  . .\ *. . . *..  .** .*.. ...  *.\. *  .*#
#.\*.*\.*.*   .\ .*\ *.*\* .* .*  .*.* . .\.\   *.\**.* ..\**** .    * .#
# ** .  \ . \    \* .\ \..  *\. . ..\. *\   *\  . *..\*** *.*.   ...   .#
#\..\*\*. \ .*..   *.*. *.  .* ..    .\*.*.**. ...*.....* \..   .  *  * #
#.\. *. * . ...*.  .* \.*. ..* .*. *...*\\.. .  \\  **.* * . .\*...* *..#
#.  \* *   ** *.. \ *.  *. .\.. \. .  . .\. .. *.\ .*... .*    *** . .. #
#\... .*\*.. \... ... .\ ...*.*... \... . *.. *\ .. * .. .*\* ....\ *  *#
#  **    ..*.   ..* \. *. .. *. *.***  ** *.. .*\* .** ***\ .  .****.* .#
#*..\\*\.*..****\   \. \  .. .  .....  ..\.  .\*. . .** ..*...  .*...\\ #
#. *  .  .*... **  \.. \   .\.*. ..*\ ..* *\* .  .* **.\  * . .*.. *\.\\#
#*..*..* \**.  *   *.* ..\** ..*.\.* . ..\* ...\...*.*.*\  **.\.  . .\..#
#\. ..\\* . *.\\. *..\*...*..*....\**.. .*. ..*..\  *.*..\.. *.\.... .. #
#*.*  * .\. *. .*\* ..*\.\.*.*\*.**...*. . . .   *....\.. . ... . \.\.* #
#* . ... ..\.* *...****  ..\.  .*..\  . . \.* ..\.*  .   . .. \ . \.... #
#\.\      **.  \.. *  *\ .*. . .*  ..  .\*  *. .*\ . .\*... .\. .* * \ .#
#.\...... .*.\*** .. *. *.***\.\.. ** .* .....**...*... . \* . * * .   *#
#. ..\.\ * . .*..  **.\*.*.... *.*.*. .\.  .\* *  *.*\.*.\..*\.* ..   *.#
# ..  **\  *.\..*......\ .\. *\* .**  ..\  ... \\\....*..*....  .  *\*..#
#\*    **.\**...\ \ *..*\...\*.** .  *\ *** \.. ....\ .  .* *.** . . *. #
#...* .....\. .\..\   *.  *.  .* \ \.** *.\ .  .  *  ...*\\ \*. . * \.*##
#*\ ..*.\**\..\.\ *. .   \.*\. . \*   . .   \ ..\..    *\..  \* ** ...*##
#..  .**...\*\.  \..*\... ..* .\....**.   .  .*.**.  *.   * ... *.... . #
# **. .. . *.*.. .*.*\.\ .  . .*. * ..*\.\*.\ .*  . *.. * \.  \ \. \   .#
#\ *\.  * ***.\** . ..***. .  ..  **.  ......**\*.  ... . ... \... .    #
#\ *\*  ***.. \..*.*\..\..**\..*. .* \. **\.**\.* ...\ .   ..\.\ **\\. *#
# .\...*.\ * .\   *..*   ..**\ .* ..\  ....  ..**.* . **. .\....* ... *.#
#..****..* .\ .** .. **\*   *.\**.*   *.\ ***. *.*..* .. .**..*\.*.* ..##
#.*.  *  ..  . *.\   .* .  .*\..... . ** .\ *..* ..**.\*  \.\...*\.....##
# . * ...\*..* ** *.\ *...  ...\\ ..**..    .**. . .*.  *  ...\.* .*.#\##
#\*\.  .   . * *...***\ *.\ .....* \**   .\*.\* .* .**..*.*\*#.*. ..# # #
#.\.\**  \***\ .. *..**\. ** * * .* .* * *.  .* *  ..*\. . .. \.\*. ##  #
# *\.\ *  . . .  .. ..  *\.\.. . ...*. * * .  \ \   *. * .. *\. .\.\..# #
# .*  \ \ *\.* .* .*.... . ..\  . ....* ..\*. ...* .. *   . .* \..*.*..##
#\ ..... \...*. .  * .\..*  ... \...**.\* *. * .\. .*.. ... *...\...*#. #
# #\  ....*\ \*. . .\  *.\ \  .  \.*.....  ..*  . *\ .... \**. .#  ..#L##
#\ ... *\.... *#   * .*...... .**..*\ * * *. * .  **...* * .    *# ##   #
#\#*  \* \. . .\ *..  .*. *\. \*   # \ *\\*.. \  ..****###. .**.# #     #
###* . . *\ **..*\..* .  ..  *.    .. ... .*.*# .*.*** . ..  \#*#       #
#  #\ .#.# **.\...  .    .*. \  .*\ .*.\. *.*   *###\. *.*.* # .#       #
#   #.** ..*. #  * ** * \\..** .\ ..**. *..**  . ##  ..\.#*# ##*#       #
#    #*\. * *##  *.*. .  *#.#.\.*.#  * .   *\ \*\**.*\*\. # #  #        #
#     ##*#*.\*.\*. *\ # ** ** #*.\ # #\     . \#.#..****.#              #
#      #.#.##** \#*.# *#\####*** . ## #.. *\.. \#  ..\.**#              #
#       # #  #... *.. # # #**.##\*.#   #. ##.###..*\\#\.. #             #
#             #  .#*.#     #.**.*##     # *#*# #\###.###.\#             #
#              ##\ # #      ##*\#        ###\#  #  # #  # #             #
#                ## #        #*#            #       #    #              #
#########################################################################