###############
#***...R......#
#***... ...*..#
#\\\... ..\\\.#
#...... ...*..#
#..     .. *..#
#.... ....  ..#
#.... ....  ..#
#.. .       ..#
#..*. ..   ...#
#.... .. .....#
#.\.. .......*#
#.............#
#.........   .#
#############L#
